
Бисопролол таблетки	Details | - 1
Силденафил таблетки	Details | -2
Мелоксикам таблетки	Details | - 3 
Эналаприл таблетки	Details | - 4
Метформин таблетки	Details | -5


Розувастатин таблетки покрытые пленочной оболочкой	Details | - 6


Бисопролол таблетки покрытые пленочной оболочкой	Details |
Силденафил таблетки покрытые пленочной оболочкой	Details |
Кетопрофен таблетки покрытые пленочной оболочкой	Details |
Метформин таблетки покрытые пленочной оболочкой	Details |
Аторвастатин таблетки покрытые пленочной оболочкой	Details |
Эналаприл таблетки покрытые пленочной оболочкой	Details |
Диклофенак таблетки пролонгированного действия	Details |
Метформин таблетки пролонгированного действия	Details |
Диклофенак таблетки пролонгированного действия покрытые пленочной оболочкой	Details |
Диклофенак таблетки пролонгированного действия покрытые кишечнорастворимой оболочкой	Details |
Метформин таблетки с модифицированным высвобождением	Details |
Метформин таблетки с модифицированным высвобождением покрытые пленочной оболочкой	Details |
Силденафил таблетки диспергируемые	Details |
Диклофенак таблетки покрытые кишечнорастворимой оболочкой	Details |
Розувастатин капсулы	Details |
Кетопрофен капсулы	Details |
Аторвастатин капсулы	Details |
Диклофенак капсулы с модифицированным высвобождением	Details |
Кетопрофен капсулы с модифицированным высвобождением	Details |
Эналаприл набор таблеток	Details |
Диклофенак пластырь	Details |
Диклофенак суппозитории	Details |
Диклофенак гель	Details |
Кетопрофен гель	Details |
Кетопрофен гель подкожный	Details |
Диклофенак гель для наружного применения	Details |
Кетопрофен гель для наружного применения	Details |
Мелоксикам гель для наружного применения	Details |
Диклофенак мазь	Details |
Диклофенак порошок для приготовления раствора для приема внутрь	Details |
Кетопрофен гранулы	Details |
Силденафил гранулы для приема внутрь	Details |
Кетопрофен гранулы для приготовления раствора для приема внутрь	Details |
Ксилометазолин спрей для носа	Details |
Кетопрофен аэрозоль для наружного применения	Details |
Мелоксикам раствор для инъекций	Details |
Диклофенак раствор для внутримышечного введения	Details |
Мелоксикам раствор для внутримышечного введения	Details |
Кетопрофен раствор для внутривенного и внутримышечного введения	Details |
Кетопрофен раствор для полоскания	Details |
Кетопрофен пена для наружного применения	Details |
Ксилометазолин капли	Details |
Ксилометазолин капли назальные	Details |
Диклофенак капли глазные	Details |